+--------------------------------------------------------------+
|                         HEADER                               |
|  Logo                              Search   Login  Sign Up   |
+--------------------------------------------------------------+

+--------------------------------------------------------------+
|                    NAVIGATION BAR                            |
|  Home | About | Services | Products | Contact | FAQ          |
+--------------------------------------------------------------+

+--------------------------------------------------------------+
|                       HERO SECTION                           |
|--------------------------------------------------------------|
| Large Heading                     | Hero Image              |
| Short Description                 |                         |
| [Get Started] [Learn More]        |                         |
+--------------------------------------------------------------+

+--------------------------------------------------------------+
|                     FEATURED SERVICES                        |
|--------------------------------------------------------------|
|  Card 1      Card 2      Card 3      Card 4                 |
|  Icon        Icon        Icon        Icon                   |
|  Title       Title       Title       Title                  |
|  Text        Text        Text        Text                   |
+--------------------------------------------------------------+

+--------------------------------------------------------------+
|                     ABOUT US SECTION                         |
|--------------------------------------------------------------|
| Image                          About Company                |
|                                Mission                      |
|                                Vision                       |
|                                [Read More]                  |
+--------------------------------------------------------------+

+--------------------------------------------------------------+
|                  FEATURED PRODUCTS / PROJECTS                |
|--------------------------------------------------------------|
|  Card      Card      Card      Card                         |
|  Image     Image     Image     Image                        |
|  Title     Title     Title     Title                        |
+--------------------------------------------------------------+

+--------------------------------------------------------------+
|                     TESTIMONIALS                             |
|--------------------------------------------------------------|
| Customer Review | Customer Review | Customer Review          |
+--------------------------------------------------------------+

+--------------------------------------------------------------+
|                 CALL TO ACTION (CTA)                         |
|                                                              |
|      Ready to get started?                                  |
|      [Contact Us]                                            |
|                                                              |
+--------------------------------------------------------------+

+--------------------------------------------------------------+
|                         FOOTER                               |
| Company | Quick Links | Contact | Social Media | Copyright   |
+--------------------------------------------------------------+